##########
#  .     #
#    . o #
#  ooo  .#
#      o #
# p .  . #
#        #
##########
