##########
# ..   p #
# oo . o #
#  o     #
#    . o #
#    .   #
#        #
##########
